1111111111111111111111111111111111
1110000000001000100000000000000111
110CC00CCC0010E010CC000CCC000CC011
100CC0CC0000100010CC000CCC000CC001
100CCC0000001101100CC00CCC00CC0001
100CC0CC00000000000CC0CC0CC0CC0001
100CC00CC00011P11000CCC000CCC00001
110CC000CC01111111000C00000C000011
1110000000001111100000000000000111
11000CCCC00001110000CC000000CC0011
1000CCCCCC0000100000CCC00000CC0001
100CC0000CC000000000CCCC0000CC0001
100CC0000CC000000000CC0CC000CC0001
100CC0000CC001010000CC00CC00CC0001
100CC0000CC011111000CC000CC0CC0001
1000CCCCCC0001110000CC0000CCCC0001
11000CCCC00000100000CC00000CCC0011
1110000000000000000000000000000111
1111111111111111111111111111111111