   
1111111111111
1C00000000001
1000ECP000001
1C00001000001
1000000000001
100000CCCCCC1
1111111111111